111111111111111111111111111111111111111111111111
100000000000010000000000000000000000000000000001
100000000000010000000000000000000000000000000001
100000000000010000000000000000000000000000000001
100000000000010000000000000000000000000000000001
100000000000010000000000000000000000000000000001
100000000000010000000011111111111111000000000001
100000000000010000000000000000000001000000000001
100000000000010000000000000000000001000000000001
100000000000010000000000000000000001000000000001
100000000000010000000000000000000001000000000001
100000000000010000000000000000000001000000000001
100000000000010000000010000000000001000000000001
100000000000000000000020000000000001000000000001
100000000000000000000020000000000001000000000001
100000000000000000000020000000000001000000000001
100000000000000000000020000000000001000000000001
100000000000000000000020000000000001000000000001
111111111111110000000011111111111111000000000001
100000000000000000000010000000000000000000000001
100000000000000000000020000000000000000000000001
100000000000000000000020000000000000000000000001
100000000000000000000020000000000000000000000001
100000000000000000000020000000000000000000000001
111111111111111111111111111111111111111111111111