111111111111111111111111111111111111111111111111
100000000100000000000000000000000000000000000001
100000000100000000000000000000000000000000000001
100000000100000000000000000000000000000000000001
100000000100000000000000000000000000000000000001
100000000100000000111111122222222222211111111111
100000000000000000000000000000000000000000000001
100000000000000000000000000000000000000000000001
100000000000000000000000000000000000000000000001
100000000000000000000000000000000000000000000001
122222222111111111111111122222222222210000000001
100000000000000000000000000000000000000000000001
100000000000000000000000000000000000000000000001
100000000000000000000000000000000000000000000001
100000000111111111111111122222222222210000000001
100000000000000000000000000000000000010000000001
100000000000000000000000000000000000010000000001
100000000000000000000000000000000000010000000001
100000000000000000000000000000000000010000000001
100000000111111111100000000000000000010000000001
100000000000000000100000000000000000010000000001
100000000000000000100000000000000000010000000001
100000000000000000100000000000000000010000000001
100000000000000000100000000000000000010000000001
111111111111111111111111111111111111111111111111