111111111111111111111111111111111111111111111111
100000000000000000000000000000000000000000000001
100000000000000000000000000000000000000000000001
100000000000000000000000000000000000000000000001
100000000000000000000000000000000000000000000001
100000000000000000000000000000000000000000000001
100000000000111111111111111111111111110000000001
100000000000000000000000000000000000010000000001
100000000000000000000000000000000000010000000001
100000000000000000000000000000000000010000000001
100000000000000000000000000000000000010000000001
100000000000000000000000000000000000010000000001
122222222222111111111111000000000000010000000001
100000000000000000000000000000000000010000000001
100000000000000000000000000000000000010000000001
100000000000000000000000000000000000010000000001
100000000000000000000000000000000000010000000001
100000000000000000000000000000000000010000000001
100000000000100000000001111111111111110000000001
100000000000100000000000000000000000020000000001
100000000000100000000000000000000000020000000001
100000000000100000000000000000000000020000000001
100000000000100000000000000000000000020000000001
100000000000100000000000000000000000020000000001
111111111111111111111111111111111111111111111111