111111111111111111111111111111111111111111111111
100000000000000000000010000000000000000000000001
100000000000000000000010000000000000000000000001
100000000000000000000010000000000000000000000001
100000000000000000000010000000000000000000000001
100000000001000000000011111111111110000000000001
100000000001000000000000000000000010000000000001
100000000001000000000000000000000010000000000001
100000000001000000000000000000000010000000000001
100000000001000000000000000000000010000000000001
111111111111000000000010000000000010000000000001
100000000000000000000010000000000000000000000001
100000000000000000000010000000000000000000000001
100000000000000000000010000000000000000000000001
100000000000000000000011111111111111111111111111
100000000001000000000000000000000000000000000001
100000000001000000000000000000000000000000000001
100000000001000000000000000000000000000000000001
100000000001000000000000000000000000000000000001
100000000001111111111111111111111110000000000001
100000000000000000000000000000000010000000000001
100000000000000000000000000000000010000000000001
100000000000000000000000000000000010000000000001
100000000000000000000000000000000010000000000001
111111111111111111111111111111111111111111111111