111111111111111111111111111111111111111111111111
100000000010000000000000000000000000000000000001
100000000010000000000000000000000000000000000001
100000000010000000000000000000000000000000000001
100000000010000000000000000000000000000000000001
100000000010000000011111111111111100000000000001
100000000010000000010000000000000000000000000001
100000000010000000010000000000000000000000000001
100000000010000000010000000000000000000000000001
100000000010000000010000000000000000000000000001
100000000010000000010000000000000011111111111111
100000000000000000010000000000000000000000000001
100000000000000000010000000000000000000000000001
100000000000000000010000000000000000000000000001
122222222211111111110000000000000000000000000001
100000000000000000000000000000000100000000000001
100000000000000000000000000000000100000000000001
100000000000000000000000000000000100000000000001
100000000000000000000000000000000100000000000001
100000000011111111111111111111111100000000000001
100000000000000000000000000000000200000000000001
100000000000000000000000000000000200000000000001
100000000000000000000000000000000200000000000001
100000000000000000000000000000000200000000000001
111111111111111111111111111111111111111111111111