111111111111111111111111111111111111111111111111
100000000000000000020000000000000000000000000001
100000000000000000020000000000000000000000000001
100000000000000000020000000000000000000000000001
100000000000000000020000000000000000000000000001
111111111100000000010000000000000000001111111111
100000000000000000010000000000000000000000000001
100000000000000000010000000000000000000000000001
100000000000000000010000000000000000000000000001
100000000011111111110000000000000000010000000001
100000000000000000000000000000000000010000000001
100000000000000000000000000000000000010000000001
100000000000000000000000000000000000010000000001
100000000000000000000000000000000000010000000001
100000000011111111111111111111111111110000000001
100000000000000000000000000000000000010000000001
100000000000000000000000000000000000010000000001
100000000000000000000000000000000000010000000001
100000000000000000000000000000000000010000000001
111111111100000000011111222222222111110000000001
100000000000000000020000000000000000000000000001
100000000000000000020000000000000000000000000001
100000000000000000020000000000000000000000000001
100000000000000000020000000000000000000000000001
111111111111111111111111111111111111111111111111