111111111111111111111111111111111111111111111111
100000000000000000000000000000000000000000000001
100000000000000000000000000000000000000000000001
100000000000000000000000000000000000000000000001
100000000000000000000000000000000000000000000001
100000000000000000000000000000000000000000000001
100000000000001111111111111111111111000000000001
100000000000001000000000000000000000000000000001
100000000000001000000000000000000000000000000001
100000000000001000000000000000000000000000000001
100000000000001000000000000000000000000000000001
100000000000001000000000000000000000000000000001
100000000000001000000001000000000000111111111111
100000000000001000000001000000000000000000000001
100000000000001000000001000000000000000000000001
100000000000001000000001000000000000000000000001
100000000000001000000001000000000000000000000001
100000000000001000000001111111111111000000000001
100000000000001000000000000000000002000000000001
100000000000001000000000000000000002000000000001
100000000000001000000000000000000002000000000001
100000000000001000000000000000000002000000000001
100000000000001000000000000000000002000000000001
100000000000001000000000000000000002000000000001
111111111111111111111111111111111111111111111111