111111111111111111111111111111111111111111111111
100000000000000000000000000000000000000000000001
100000000000000000000000000000000000000000000001
100000000000000000000000000000000000000000000001
10000P000000000000000000000000000000000000000001
100000000000000000000000000000000000000000000001
100000000000111222222222221110000000100000000001
100000000000100000000000000010000000100000000001
100000000000100000000000000010000000100000000001
100000000000100000000000000010000000100000000001
100000000000100000000000000010000000100000000001
100000000000100000000000000010000000100000000001
100000000000100000000000000010000000111111111111
100000000000000000000000000010000000000000000001
100000000000000000000000000010000000000000000001
100000000000000000000000000010000000000000000001
100000000000000000000000000010000000000000000001
100000000000000000000000000010000000000000000001
100000000000111111111111111111111111100000000001
100000000000000000000000000010000000000000000001
100000000000000000000000000010000000000000000001
100000000000000000000000000010000000000000000001
100000000000000000000000000010000000000000Q00001
100000000000000000000000000010000000000000000001
111111111111111111111111111111111111111111111111