111111111111111111111111111111111111111111111111
100000000000000000000000000000000000001000000001
100000000000000000000000000000000000001000000001
100000000000000000000000000000000000001000000001
100000000000000000000000000000000000001000000001
100000000000011111111111111000000000001000000001
100000000000000000000000002000000000000000000001
100000000000000000000000001000000000000000000001
100000000000000000000000002000000000000000000001
100000000000000000000000002000000000000000000001
100000000000010000000000001111111111111222222221
100000000000010000000000000000000000000000000001
100000000000010000000000000000000000000000000001
100000000000010000000000000000000000000000000001
100000000000010000000000000000000000000000000001
111111111111110000000000001111111111111000000001
100000000000000000000000000000000000002000000001
100000000000000000000000000000000000002000000001
100000000000000000000000000000000000002000000001
100000000000000000000000000000000000002000000001
100000000000011111111111111111111111111000000001
100000000000000000000000001000000000000000000001
100000000000000000000000001000000000000000000001
100000000000000000000000001000000000000000000001
111111111111111111111111111111111111111111111111